00000000000000000000
00011000000000110000
00000000000000000000
00000000000000000000
00000000000000000000
00000000000000000000
00000000111111000000
00000000122221000000
00000011133321000000
00000015234421000000
00000012344411000000
00000011112210000000
00000000011110000000
00000000000000000000
00000000000000000000
00000000000000000000
00011000000000110000
00000000000000000000
00000000000000000000
00000000000000000000