00000000000000000000
00001100000000011000
00000000000000000000
00000000000000000000
00000000000000000000
00000111111100000000
00000122222111000000
00001131112221000000
00001522322321000000
00001244123211000000
00001144122210000000
00000111111110000000
00000000000000000000
00000000000000000000
00000000000000000000
00000000000000000000
00011000000000110000
00000000000000000000
00000000000000000000
00000000000000000000