00000000000000000000
00000000000000000000
00000011111100000000
00000011111100000000
00000000000000000000
00000000000000000000
00000000000000000000
00000000011111110000
00000000112212510000
00000000122213210000
00000000132232210000
00000000123112210000
00000011123212110000
00000014444422100000
00000011111111100000
00000000000000000000
00000000000000000000
00000000000000000000
00000000000000000000
00000000000000000000