00000000000000000000
00011000000000001100
00000000000000000000
00000000000000000000
00000000000000000000
00000000000000000000
00000000011111100000
00000001112222100000
00000011423112110000
00000014432322510000
00000014423232110000
00000011111122100000
00000000000111100000
00000000000000000000
00000000000000000000
00000000000000000000
00000000000000000000
00011100000000111000
00000000000000000000
00000000000000000000